ISSUER NAME	CLASS TITLE	CUSIP	VALUE ($thousands)	INVESTMENT DISCRETION	SHRS or PRN AMOUNT	SH or PRN	VOTING AUTH SOLE	VOTING AUTH SHARED	VOTING AUTH NONE
SELECT SECTOR SPDR TR	SBI INT-UTILS	81369Y886	753	SOLE	14230	SH	14141	0	89
DIAGEO P L C	SPON ADR NEW	25243Q205	225	SOLE	1584	SH	279	0	1305
MCDONALDS CORP	COM	580135101	628	SOLE	3535	SH	3402	0	133
PIMCO ETF TR	25YR+ ZERO U S	72201R882	787	SOLE	7000	SH	6956	0	44
3M CO	COM	88579Y101	527	SOLE	2765	SH	2659	0	106
WISDOMTREE TR	US MIDCP EARNING	97717W570	510	SOLE	14861	SH	14861	0	0
INTEL CORP	COM	458140100	512	SOLE	10904	SH	10532	0	372
STARBUCKS CORP	COM	855244109	634	SOLE	9849	SH	9576	0	273
ISHARES TR	TIPS BD ETF	464287176	233	SOLE	2132	SH	314	0	1818
EXXON MOBIL CORP	COM	30231G102	648	SOLE	9510	SH	9295	0	215
LILLY ELI  CO	COM	532457108	1577	SOLE	13627	SH	13532	0	95
ALPHABET INC	CAP STK CL C	02079K107	676	SOLE	653	SH	320	0	333
MICROSOFT CORP	COM	594918104	632	SOLE	6226	SH	5781	0	445
NUVEEN MUN VALUE FD INC	COM	670928100	185	SOLE	20000	SH	0	0	20000
CISCO SYS INC	COM	17275R102	582	SOLE	13443	SH	13098	0	345
SCHWAB STRATEGIC TR	SHT TM US TRES	808524862	3346	SOLE	67047	SH	66623	0	424
SCHWAB STRATEGIC TR	US DIVIDEND EQ	808524797	2389	SOLE	50859	SH	41365	0	9494
NOVARTIS A G	SPONSORED ADR	66987V109	305	SOLE	3555	SH	875	0	2680
MOLINA HEALTHCARE INC	COM	60855R100	654	SOLE	5628	SH	4812	0	816
LATTICE STRATEGIES TR	HARTFORD MLT ETF	518416102	274	SOLE	10603	SH	10603	0	0
HOME DEPOT INC	COM	437076102	901	SOLE	5246	SH	5186	0	60
ISHARES TR	CORE SP500 ETF	464287200	1702	SOLE	6765	SH	6587	0	178
ISHARES GOLD TRUST	ISHARES	464285105	342	SOLE	27820	SH	27201	0	619
ISHARES TR	CORE HIGH DV ETF	46429B663	338	SOLE	4007	SH	1642	0	2365
BERKSHIRE HATHAWAY INC DEL	CL B NEW	084670702	807	SOLE	3953	SH	1487	0	2466
ALPS ETF TR	ALERIAN MLP	00162Q866	287	SOLE	32825	SH	0	0	32825
HONEYWELL INTL INC	COM	438516106	212	SOLE	1605	SH	1431	0	174
INTERNATIONAL FLAVORSFRAGRA	COM	459506101	213	SOLE	1590	SH	0	0	1590
MURPHY USA INC	COM	626755102	310	SOLE	4045	SH	0	0	4045
SPDR SERIES TRUST	PORTFOLIO LN TSR	78464A664	1574	SOLE	44917	SH	44597	0	320
EATON VANCE ENHANCED EQ INC	COM	278274105	1336	SOLE	103187	SH	101164	0	2023
DELTA AIR LINES INC DEL	COM NEW	247361702	645	SOLE	12932	SH	10912	0	2020
FLEETCOR TECHNOLOGIES INC	COM	339041105	202	SOLE	1090	SH	0	0	1090
WORLD WRESTLING ENTMT INC	CL A	98156Q108	667	SOLE	8931	SH	8389	0	542
DISNEY WALT CO	COM DISNEY	254687106	310	SOLE	2828	SH	2725	0	103
WALMART INC	COM	931142103	445	SOLE	4781	SH	4661	0	120
SCHWAB STRATEGIC TR	EMRG MKTEQ ETF	808524706	373	SOLE	15845	SH	15750	0	95
TJX COS INC NEW	COM	872540109	859	SOLE	19210	SH	19140	0	70
NIKE INC	CL B	654106103	261	SOLE	3518	SH	3423	0	95
US BANCORP DEL	COM NEW	902973304	413	SOLE	9036	SH	1931	0	7105
CHEVRON CORP NEW	COM	166764100	250	SOLE	2301	SH	2211	0	90
VERIZON COMMUNICATIONS INC	COM	92343V104	1265	SOLE	22498	SH	12425	0	10073
TRIBUNE MEDIA CO	CL A	896047503	379	SOLE	8342	SH	0	0	8342
ALTRIA GROUP INC	COM	02209S103	721	SOLE	14591	SH	8413	0	6178
MERCK  CO INC	COM	58933Y105	1130	SOLE	14787	SH	8400	0	6387
ISHARES TR	US HOME CONS ETF	464288752	856	SOLE	28484	SH	22836	0	5648
SWEDISH EXPT CR CORP	ROG TTL ETN 22	870297801	278	SOLE	56917	SH	56537	0	380
ADVISORSHARES TR	RANGER EQUITY BE	00768Y883	229	SOLE	27110	SH	0	0	27110
ISHARES TR	MIN VOL USA ETF	46429B697	1328	SOLE	25348	SH	25348	0	0
AMAZON COM INC	COM	023135106	862	SOLE	574	SH	547	0	27
JPMORGAN CHASE  CO	COM	46625H100	406	SOLE	4158	SH	3896	0	262
WISDOMTREE TR	BLMBG US BULL	97717W471	747	SOLE	27615	SH	27426	0	189
UNITEDHEALTH GROUP INC	COM	91324P102	711	SOLE	2854	SH	2794	0	60
BOEING CO	COM	097023105	321	SOLE	995	SH	520	0	475
TESLA INC	COM	88160R101	333	SOLE	1000	SH	1000	0	0
INVESCO QQQ TR	UNIT SER 1	46138E354	1516	SOLE	9829	SH	9636	0	193
MAGELLAN MIDSTREAM PRTNRS LP	COM UNIT RP LP	559080106	292	SOLE	5110	SH	0	0	5110
COLGATE PALMOLIVE CO	COM	194162103	1176	SOLE	19752	SH	19742	0	10
COCA COLA CO	COM	191216100	897	SOLE	18934	SH	10404	0	8530
AGILE THERAPEUTICS INC	COM	00847L100	6	SOLE	10000	SH	10000	0	0
VANGUARD INDEX FDS	GROWTH ETF	922908736	432	SOLE	3214	SH	45	0	3169
SCHWAB STRATEGIC TR	US AGGREGATE B	808524839	7575	SOLE	149742	SH	123409	0	26333
ORACLE CORP	COM	68389X105	1151	SOLE	25495	SH	16240	0	9255
ISHARES TR	USA MOMENTUM FCT	46432F396	254	SOLE	2531	SH	2531	0	0
ZOETIS INC	CL A	98978V103	1039	SOLE	12142	SH	8573	0	3569
INVESCO EXCHANGE TRADED FD T	SP500 EQL WGT	46137V357	1004	SOLE	10988	SH	10914	0	74
MASTERCARD INCORPORATED	CL A	57636Q104	870	SOLE	4613	SH	4553	0	60
VANGUARD INDEX FDS	VALUE ETF	922908744	718	SOLE	7326	SH	65	0	7261
PFIZER INC	COM	717081103	1111	SOLE	25459	SH	23937	0	1522
PIMCO ETF TR	INV GRD CRP BD	72201R817	1266	SOLE	12778	SH	12698	0	80
SCHWAB STRATEGIC TR	US REIT ETF	808524847	662	SOLE	17184	SH	17068	0	116
BIG LOTS INC	COM	089302103	721	SOLE	24944	SH	21294	0	3650
SCHWAB STRATEGIC TR	US SML CAP ETF	808524607	908	SOLE	14969	SH	14870	0	99
BECTON DICKINSON  CO	COM	075887109	810	SOLE	3595	SH	3485	0	110
TWENTY FIRST CENTY FOX INC	CL A	90130A101	235	SOLE	4885	SH	0	0	4885
ABBVIE INC	COM	00287Y109	245	SOLE	2652	SH	2637	0	15
PACER FDS TR	US CASH COWS 100	69374H881	372	SOLE	14471	SH	13919	0	552
BANK AMER CORP	COM	060505104	386	SOLE	15669	SH	14363	0	1306
OMNICOM GROUP INC	COM	681919106	326	SOLE	4447	SH	4294	0	153
BROWN FORMAN CORP	CL B	115637209	698	SOLE	14669	SH	12027	0	2642
JOHNSON  JOHNSON	COM	478160104	1506	SOLE	11673	SH	7066	0	4607
INVESCO EXCHNG TRADED FD TR	PFD ETF	46138E511	1910	SOLE	141827	SH	105390	0	36437
PEPSICO INC	COM	713448108	233	SOLE	2105	SH	2025	0	80
SPDR GOLD TRUST	GOLD SHS	78463V107	215	SOLE	1774	SH	74	0	1700
UNITED PARCEL SERVICE INC	CL B	911312106	32458	SOLE	332802	SH	260444	0	72358
INVESCO EXCHNG TRADED FD TR	SP500 LOW VOL	46138E354	1049	SOLE	22487	SH	21907	0	580
EXELON CORP	COM	30161N101	222	SOLE	4920	SH	4900	0	20
PROCTER AND GAMBLE CO	COM	742718109	944	SOLE	10273	SH	8091	0	2182
BLACKROCK ENHANCED INTL DIV	COM BENE INTER	092524107	94	SOLE	18805	SH	18805	0	0
ISHARES TR	RUSSELL 2000 ETF	464287655	366	SOLE	2736	SH	274	0	2462
WALGREENS BOOTS ALLIANCE INC	COM	931427108	938	SOLE	13722	SH	13629	0	93
AUTOMATIC DATA PROCESSING IN	COM	053015103	463	SOLE	3531	SH	3469	0	62
PRICE T ROWE GROUP INC	COM	74144T108	650	SOLE	7040	SH	7030	0	10
CVS HEALTH CORP	COM	126650100	469	SOLE	7166	SH	7018	0	148
NORFOLK SOUTHERN CORP	COM	655844108	453	SOLE	3032	SH	3012	0	20
COMCAST CORP NEW	CL A	20030N101	711	SOLE	20889	SH	2398	0	18491
ISHARES TR	NATIONAL MUN ETF	464288414	204	SOLE	1870	SH	0	0	1870
DICKS SPORTING GOODS INC	COM	253393102	344	SOLE	11040	SH	10946	0	94
SELECT SECTOR SPDR TR	SBI CONS STPLS	81369Y308	814	SOLE	16029	SH	12838	0	3191
WESTERN GAS PARTNERS LP	COM UNIT LP IN	958254104	305	SOLE	7220	SH	0	0	7220
UNITED STATES OIL FUND LP	UNITS	91232N108	109	SOLE	11333	SH	11333	0	0
VIVEVE MED INC	COM NEW	92852W204	16	SOLE	14895	SH	0	0	14895
WELLS FARGO CO NEW	COM	949746101	255	SOLE	5541	SH	746	0	4795
ISHARES TR	DOW JONES US ETF	464287846	611	SOLE	4907	SH	4907	0	0
UNION PAC CORP	COM	907818108	462	SOLE	3344	SH	3265	0	79
ENTERPRISE PRODS PARTNERS L	COM	293792107	322	SOLE	13080	SH	0	0	13080
SPDR INDEX SHS FDS	DJ GLB RL ES ETF	78463X749	318	SOLE	7175	SH	352	0	6823
ISHARES TR	MSCI EAFE ETF	464287465	933	SOLE	15866	SH	1415	0	14451
APPLE INC	COM	037833100	1772	SOLE	11233	SH	10887	0	346
ATT INC	COM	00206R102	411	SOLE	14398	SH	5876	0	8522
INTERNATIONAL BUSINESS MACHS	COM	459200101	1002	SOLE	8818	SH	6638	0	2180
CANADIAN NATL RY CO	COM	136375102	362	SOLE	4888	SH	4888	0	0
